###############################################################
#11                                                           #
#11        ###                                 ###     #      #
#          #######----####                    #       #       #
#          #######----####             ###--##     ###        #
#                                      #         ##           #
#      ##                    ######    #        #             #
#########          ###---#         ##-##        #          ####
#########                #                 ###                #
#########                #                 ###             #  #
#########          ###---#         ##-##        #          ####
#      ##                    ######    #        #             #
#                                      #         ##           #
#          #######----####             ###--##     ###        #
#          #######----####                    #       #       #
#          ###                                 ###     #      #
#                                                          ####
#                                                           F #
#          ###                                 ###     #   ####
#          #######----####                    #       #       #
#          #######----####             ###--##     ###        #
#                                      #         ##           #
#      ##                    ######    #        #             #
#########          ###---#         ##-##        #          ####
#########                #                 ###                #
#########                #                 ###             #  #
#########          ###---#         ##-##        #          ####
#      ##                    ######    #        #             #
#                                      #         ##           #
#          #######----####             ###--##     ###        #
#          #######----####                    #       #       #
#22        ###                                 ###     #      #
#22                                                           #
###############################################################
